.,.,.,.,.,.,.,.,.,.,.,.,.,.,.,.,.,.
*,@,.,.,.,@,*,*,*,.,*,.,*,.,*,.,*,*
#,@,.,.,.,@,#,#,#,#,#,#,#,#,#,#,#,#
#,@,.,U,.,@,#,#,#,#,#,#,@,#,#,#,#,#
#,@,.,.,.,@,#,#,#,#,#,#,#,#,#,#,#,#
.,@,.,.,.,@,.,.,.,.,.,.,.,.,.,.,.,.
.,.,.,.,.,.,.,.,.,.,.,.,.,.,.,.,.,.
.,@,.,.,.,@,@,@,@,@,.,.,@,@,@,@,@,@
.,.,.,.,.,@,.,.,.,@,.,.,@,.,.,.,.,@
.,@,.,.,.,.,.,.,.,.,.,.,.,.,.,.,.,.
.,.,.,.,.,@,.,.,.,@,.,.,@,.,.,.,.,@
.,.,.,.,.,@,@,.,@,@,.,.,@,@,.,@,@,@
.,.,.,.,.,.,.,.,.,.,.,.,.,.,.,.,.,.
.,.,.,B,.,.,.,.,.,.,.,.,.,.,.,.,.,.
.,.,.,*,.,.,.,@,@,.,@,@,@,@,@,@,@,@
.,.,*,#,*,.,.,@,.,.,.,.,@,.,.,.,.,.
.,.,.,*,.,.,.,@,.,.,.,.,@,.,.,.,.,.
.,.,.,.,.,.,.,@,.,.,.,.,@,.,.,.,.,.